0 3 5 0 9 0 0 4 8
0 0 9 0 0 8 0 0 3
0 4 0 6 0 5 0 0 1
0 0 0 0 7 4 0 0 0
0 2 0 0 0 0 0 6 0
0 0 0 1 5 0 0 0 0
8 0 0 9 0 2 0 7 0
9 0 0 5 0 0 2 0 0
6 1 0 0 4 0 5 3 0
